PPPPPPPPPPPPPPPPPPPPPPPPPPPPPPPPPPP
PCCCCCCCCCCCCCCCCPCCCCCCCCCCCCCCCCP
PCCCCCCCCCCCCCCCCPCCCCCCCCCCCCCCCCP
PCCPPCCCPPPPPPCCCPCCCPPPPPPCCCPPCCP
PCCPPPPPPPPPPPPPPPPPPPPPPPPPPPPPCCP
PCCCCCCCCCCCCCCCCCCCCCCCCCCCCCCCCCP
PCCCCCCCCCCCCCCCCCCCCCCCCCCCCCCCCCP
PCCPPCCPCCCPPPPPPPPPPPPPCCCPCCPPCCP
PCCPPCCPCCCCCCCCCPCCCCCCCCCPCCPPCCP
PCCCCCCPPPPPCCCCCPCCCCCPPPPPCCCCCCP
PCCCCCCPCCCCCCCCCPCCCCCCCCCPCCCCCCP
PPPPPCCPCCCCCCCCCCCCCCCCCCCPCCPPPPP
PPCCCCCCCCCCPPPPPPPPPPPCCCCCCCCCCPP
PPCCCCCCCCCCPPPPPPPPPPPCCCCCCCCCCPP
PPPPPCCPCCCCPPPPPPPPPPPCCCCPCCPPPPP
PPPPPCCPCCCCCCCCCCCCCCCCCCCPCCPPPPP
PCCCCCCCCCCCPPPPPPPPPPPCCCCCCCCCCCP
PCCCCCCCCCCCCCCCCPCCCCCCCCCCCCCCCCP
PCCPPCCCCCCPPPCCCPCCCPPPPCCCCCPPCCP
PCCCPCCCCCCCCCCCCCCCCCCCCCCCCCPCCCP
PCCCCCCCCCCCCCCCCCCCCCCCCCCCCCCCCCP
PPCCPCCCCCCPCPPPPPPPPPCPCCCCCPPCCPP
PCCCCCCCCCCPCCCCCCPCCCCPCCCCCCCCCCP
PCCCCCCCCCCPCCCCCPPCCCCCPCCCCCCCCCP
PCCPPPPPPPPPCCCPPPPCCCCPPPPPPPPCCPP
PCCCCCCCCCCCCCCCCCCCCCCCCCCCCCCCCCP
PPPPPPPPPPPPPPPPPPPPPPPPPPPPPPPPPPP
