PPPPPPPPPPPPPPPPPPPPPPPPPPPPPPPPPPP
PCCCCCCCCCCCCCCCEPCCCCCCCCCCCCCCCCP
PCCCCCCCCCCCCCCCCPCCCCCCCCCCCCCCCCP
PCCPPCCCPPPPPPCCCPCCCPPPPPPECCPPCCP
PCCPPPPPPPPPPPPPPPPPPPPPPPPPPPPPCCP
PCCCCCCCCCCCCCCCCCCCCCCCCCCCCCCCCCP
PCCCCCCCCCCCCCCCCCCCCCCCCCCCCCCCCCP
PCCPPCCPCCCPPPPPPPPPPPPPCCCPCCPPCCP
PCCPPCCPCCCCCCCCCPCCCCCCCCCPCEPPCCP
PCCCCCCPPPPPCCCCCPCCCCCPPPPPCCCCCCP
PCCCCCCPCCCCCCCCCPCCCCCCCCCPCCCCCCP
PPPPPCCPCCCCCCCCCECCCCCCCCCPCCPPPPP
PPCCCCCCCCCCPPPPPPPPPPPCCCCCCCCCCPP
PPCCCCCCCCCCPPPPPPPPPPPCCCCCCCCCCPP
PPPPPCCPCCCCPPPPPPPPPPPCCCCPCCPPPPP
PPPPPCCPCCCCCCCCCCCCCCCCCCCPCCPPPPP
PCCCCCCCCCCCPPPPPPPPPPPCCCCCCCCCCCP
PCCCCCCCCCCCCCCCCPCCCCCCCCCCCCCCCCP
PECPPCCCCCCPPPCCCPCCCPPPPCCCCCPPCCP
PCCCPCCCCCCCCCCCCCCCCCCCCCCCCCPECCP
PCCCPCCCCCCCCCCCCCCCCCCCCCCCCCCCCCP
PPCCPCCCCCCPCPPPPPPPPPCPCCCCCPPCCPP
PCCCCCCCCCCPCCCCCṔPCCCCPCCCCCCCCCCP
PCCCCCCCCCCPCCCCCPPCCCCCPCCCCCCCCCP
PCCPPPPPPPPPCCCCCPPCCCCPPPPPPPPPCCP
PCCCCCCCCCCCCCCCCECCCCCCCCCCCCCCCCP
PPPPPPPPPPPPPPPPPPPPPPPPPPPPPPPPPPP
