PPPPPPPPPPPPPPPPPPPPPPPPPPPPPPPPPPP
PCCCCCCCCCCCCCCCEPCCCCCCCCCCCCCCCCP
PCCCCCCCCCCCCCCCCPCCCCCCCCCCCCCCCCP
PCCPPCCCPPPPPPCCCPCCCPPPPPPECCPPCCP
PCCPPPPPPPPPPPPPPPPPPPPPPPPPPPPPCCP
PCCCCCCCCCCCCCCCCCCCCCCCCCCCCCCCCCP
PCCCCCCCCCCCCCCCCCCCCCCCCCCCCCCCCCP
PCCPPCCPCCCPPPPPPPPPPPPPCCCPCCPPCCP
PCCPPCCPCCCCCCCCCPCCCCCCCCCPCEPPCCP
PCCCCCCPPPPPCCCCCPCCCCCPPPPPCCCCCCP
PCCCCCCPCCCCCCCCCPCCCCCCCCCPCCCCCCP
PPPPPCCPCCCCCCCCCECCCCCCCCCPCCPPPPP
PPCCCCCCCCCCPPPPPPPPPPPCCCCCCCCCCPP
PPCCCCCCCCCCPPPPPPPPPPPCCCCCCCCCCPP
PPPPPCCPCCCCPPPPPPPPPPPCCCCPCCPPPPP
PPPPPCCPCCCCCCCCCCCCCCCCCCCPCCPPPPP
PCCCCCCCCCCCPPPPPPPPPPPCCCCCCCCCCCP
PCCCCCCCCCCCCCCCCPCCCCCCCCCCCCCCCCP
PECPPCCCCCCPPPCCCPCCCPPPPCCCCCPPCCP
PCCCPCCCCCCCCCCCCCCCCCCCCCCCCCPECCP
PCCCCCCCCCCCCCCCCCCCCCCCCCCCCCCCCCP
PPCCPCCCCCCPCPPPPPPPPPCPCCCCCPPCCPP
PCCCCCCCCCCPCCCCCEPCCCCPCCCCCCCCCCP
PCCCCCCCCCCPCCCCCPPCCCCCPCCCCCCCCCP
PCCPPPPPPPPPCCCPPPPCCCCPPPPPPPPCCPP
PCCCCCCCCCCCCCCCCCCCCCCCCCCCCCCCCCP
PPPPPPPPPPPPPPPPPPPPPPPPPPPPPPPPPPP
